########
#.     #
#. $ @ #
#      #
########