########
#.     #
# $$@  #
#.     #
########