########
#      #
#. $@@ #
#      #
########