########
#      #
#. $   #
#      #
########