########
#.   ¨ #
#. $ @ #
#      #
########