##################
#.#         #   .#
# #    #$#     # #
# #   ## ##$     #
#   #   @    # # #
#    $## ##  ### #
# ###  # #    $  #
#.             #.#
##################