########
#      #
#. $@  #
#      #
########